111111111111111
1E0C0000000C001
100100000001001
100000000000001
100100000001001
100C000000000P1
10000000000C001
100100000001001
100000000000001
100C0000000C001
100100000001001
100000000000001
111111111111111